0000000000000
00000000000000000
00002222022220000
00002000020000
00002033333020000
00002030403020000
00002000000020000
00002222222220000
00000000000000000
00000000000000000
